10 20
XXXXXXXXXXXXXXXXXXXX
X X        X       X
X X XXXX XXX XXXXXXX
X X X              X
X X X XXXXX XXX X XX
X XXX X   X X X X XX
X     X   X X XXXXXX
X XXXXX X X        X
X X     X   X   XX X
XXXXXXXXXXXXXXXXXXXX
